##########
##########
##########
..........
..........
..........
....==....
##......##
##..==..##
##......##
##......##
##..==..##
##......##
....==....
..........
..........
..........
##########
##########
##########