###....###########################################################
###....###########################################################
###==..###########################################################
###...............................................................
###...............................................................
###...............................................................
###...............................................................
###########################################....###################
###########################################....###################
###########################################..==###################
