###....######################
###....######################
###==..######################
###..........................
###..........................
###..........................
###..........................
######....###################
######....###################
######..==###################
