###....########################################################################
###....########################################################################
###==..########################################################################
###............................................................................
###............................................................................
###............................................................................
###............................................................................
########################################################....###################
########################################################....###################
########################################################..==###################
