#################################....###################
#################################....###################
#################################==..###################
###.....................................................
###.....................................................
###.....................................................
###.....................................................
###....#################################################
###....#################################################
###..==#################################################
