######....################
######....################
######==..################
###.......................
###.......................
###.......................
###.......................
###....###################
###....###################
###..==###################
