###....###############################################################
###....###############################################################
###==..###############################################################
###...................................................................
###...................................................................
###...................................................................
###...................................................................
###############################################....###################
###############################################....###################
###############################################..==###################
