###....###################
###....###################
###==..###################
###.......................
###.......................
###.......................
###.......................
##################....####
##################....####
##################..==####
