###################....######
###################....######
###################==..######
###..........................
###..........................
###..........................
###..........................
###....######################
###....######################
###..==######################
