###....#########################################
###....#########################################
###==..#########################################
###.............................................
###.............................................
###.............................................
###.............................................
#########################....###################
#########################....###################
#########################..==###################
