###....#############################################
###....#############################################
###==..#############################################
###.................................................
###.................................................
###.................................................
###.................................................
#############################....###################
#############################....###################
#############################..==###################
