###....###################
###....###################
###==..###################
###.......................
###.......................
###.......................
###.......................
################....######
################....######
################..==######
