###....########################################
###....########################################
###==..########################################
###............................................
###............................................
###............................................
###............................................
########################....###################
########################....###################
########################..==###################
