#########....#############
#########....#############
#########==..#############
###.......................
###.......................
###.......................
###.......................
###....###################
###....###################
###..==###################
