###....##############################################
###....##############################################
###==..##############################################
###..................................................
###..................................................
###..................................................
###..................................................
##############################....###################
##############################....###################
##############################..==###################
