###....###########################################
###....###########################################
###==..###########################################
###...............................................
###...............................................
###...............................................
###...............................................
###########################....###################
###########################....###################
###########################..==###################
