################....######
################....######
################==..######
###.......................
###.......................
###.......................
###.......................
###....###################
###....###################
###..==###################
