###....################################################################
###....################################################################
###==..################################################################
###....................................................................
###....................................................................
###....................................................................
###....................................................................
################################################....###################
################################################....###################
################################################..==###################
