#######....###############
#######....###############
#######==..###############
###.......................
###.......................
###.......................
###.......................
###....###################
###....###################
###..==###################
