###########################....###################
###########################....###################
###########################==..###################
###...............................................
###...............................................
###...............................................
###...............................................
###....###########################################
###....###########################################
###..==###########################################
