###....#######################
###....#######################
###==..#######################
###...........................
###...........................
###...........................
###...........................
#######....###################
#######....###################
#######..==###################
