####################################....###################
####################################....###################
####################################==..###################
###........................................................
###........................................................
###........................................................
###........................................................
###....####################################################
###....####################################################
###..==####################################################
