###....###################
###....###################
###==..###################
###.......................
###.......................
###.......................
###.......................
###########....###########
###########....###########
###########..==###########
