########################....###################
########################....###################
########################==..###################
###............................................
###............................................
###............................................
###............................................
###....########################################
###....########################################
###..==########################################
