########################################################....###################
########################################################....###################
########################################################==..###################
###............................................................................
###............................................................................
###............................................................................
###............................................................................
###....########################################################################
###....########################################################################
###..==########################################################################
