###....#################################################################
###....#################################################################
###==..#################################################################
###.....................................................................
###.....................................................................
###.....................................................................
###.....................................................................
#################################################....###################
#################################################....###################
#################################################..==###################
