###....#####################################################
###....#####################################################
###==..#####################################################
###.........................................................
###.........................................................
###.........................................................
###.........................................................
#####################################....###################
#####################################....###################
#####################################..==###################
