###....####################################################
###....####################################################
###==..####################################################
###........................................................
###........................................................
###........................................................
###........................................................
####################################....###################
####################################....###################
####################################..==###################
