###....#####################################################################
###....#####################################################################
###==..#####################################################################
###.........................................................................
###.........................................................................
###.........................................................................
###.........................................................................
#####################################################....###################
#####################################################....###################
#####################################################..==###################
