#####################....######
#####################....######
#####################==..######
###............................
###............................
###............................
###............................
###....########################
###....########################
###..==########################
