###....#################################################
###....#################################################
###==..#################################################
###.....................................................
###.....................................................
###.....................................................
###.....................................................
#################################....###################
#################################....###################
#################################..==###################
