###....##########################################################
###....##########################################################
###==..##########################################################
###..............................................................
###..............................................................
###..............................................................
###..............................................................
##########################################....###################
##########################################....###################
##########################################..==###################
