###....###################
###....###################
###==..###################
###.......................
###.......................
###.......................
###.......................
#################....#####
#################....#####
#################..==#####
