###....##########################
###....##########################
###==..##########################
###..............................
###..............................
###..............................
###..............................
##########....###################
##########....###################
##########..==###################
