###....#################################
###....#################################
###==..#################################
###.....................................
###.....................................
###.....................................
###.....................................
#################....###################
#################....###################
#################..==###################
