###....###################
###....###################
###==..###################
###.......................
###.......................
###.......................
###.......................
#######....###############
#######....###############
#######..==###############
