########....##############
########....##############
########==..##############
###.......................
###.......................
###.......................
###.......................
###....###################
###....###################
###..==###################
