###....################################################
###....################################################
###==..################################################
###....................................................
###....................................................
###....................................................
###....................................................
################################....###################
################################....###################
################################..==###################
