#######################################################....###################
#######################################################....###################
#######################################################==..###################
###...........................................................................
###...........................................................................
###...........................................................................
###...........................................................................
###....#######################################################################
###....#######################################################################
###..==#######################################################################
