############################################....###################
############################################....###################
############################################==..###################
###................................................................
###................................................................
###................................................................
###................................................................
###....############################################################
###....############################################################
###..==############################################################
