###....###################
###....###################
###==..###################
###.......................
###.......................
###.......................
###.......................
#####....#################
#####....#################
#####..==#################
