#########################################################....###################
#########################################################....###################
#########################################################==..###################
###.............................................................................
###.............................................................................
###.............................................................................
###.............................................................................
###....#########################################################################
###....#########################################################################
###..==#########################################################################
