#########################################....###################
#########################################....###################
#########################################==..###################
###.............................................................
###.............................................................
###.............................................................
###.............................................................
###....#########################################################
###....#########################################################
###..==#########################################################
