###....#####################
###....#####################
###==..#####################
###.........................
###.........................
###.........................
###.........................
#####....###################
#####....###################
#####..==###################
