###....#######################################################
###....#######################################################
###==..#######################################################
###...........................................................
###...........................................................
###...........................................................
###...........................................................
#######################################....###################
#######################################....###################
#######################################..==###################
