###....###################
###....###################
###==..###################
###.......................
###.......................
###.......................
###.......................
#############....#########
#############....#########
#############..==#########
