###....#############################
###....#############################
###==..#############################
###.................................
###.................................
###.................................
###.................................
#############....###################
#############....###################
#############..==###################
