###....##########################################
###....##########################################
###==..##########################################
###..............................................
###..............................................
###..............................................
###..............................................
##########################....###################
##########################....###################
##########################..==###################
