###################################################....###################
###################################################....###################
###################################################==..###################
###.......................................................................
###.......................................................................
###.......................................................................
###.......................................................................
###....###################################################################
###....###################################################################
###..==###################################################################
