###################################....###################
###################################....###################
###################################==..###################
###.......................................................
###.......................................................
###.......................................................
###.......................................................
###....###################################################
###....###################################################
###..==###################################################
