###....####################
###....####################
###==..####################
###........................
###........................
###........................
###........................
####....###################
####....###################
####..==###################
