######################....###################
######################....###################
######################==..###################
###..........................................
###..........................................
###..........................................
###..........................................
###....######################################
###....######################################
###..==######################################
