##################################################....###################
##################################################....###################
##################################################==..###################
###......................................................................
###......................................................................
###......................................................................
###......................................................................
###....##################################################################
###....##################################################################
###..==##################################################################
