###....##################################################
###....##################################################
###==..##################################################
###......................................................
###......................................................
###......................................................
###......................................................
##################################....###################
##################################....###################
##################################..==###################
