###....################################
###....################################
###==..################################
###....................................
###....................................
###....................................
###....................................
################....###################
################....###################
################..==###################
