############....##########
############....##########
############==..##########
###.......................
###.......................
###.......................
###.......................
###....###################
###....###################
###..==###################
