#######################################....###################
#######################################....###################
#######################################==..###################
###...........................................................
###...........................................................
###...........................................................
###...........................................................
###....#######################################################
###....#######################################################
###..==#######################################################
