###....###################
###....###################
###==..###################
###.......................
###.......................
###.......................
###.......................
####################....##
####################....##
####################..==##
