#####################################....###################
#####################################....###################
#####################################==..###################
###.........................................................
###.........................................................
###.........................................................
###.........................................................
###....#####################################################
###....#####################################################
###..==#####################################################
