###....#########################################################
###....#########################################################
###==..#########################################################
###.............................................................
###.............................................................
###.............................................................
###.............................................................
#########################################....###################
#########################################....###################
#########################################..==###################
