###....###################
###....###################
###==..###################
###.......................
###.......................
###.......................
###.......................
####....##################
####....##################
####..==##################
