###....#########################################################################
###....#########################################################################
###==..#########################################################################
###.............................................................................
###.............................................................................
###.............................................................................
###.............................................................................
#########################################################....###################
#########################################################....###################
#########################################################..==###################
