###....#########################
###....#########################
###==..#########################
###.............................
###.............................
###.............................
###.............................
#########....###################
#########....###################
#########..==###################
