###....#######################################
###....#######################################
###==..#######################################
###...........................................
###...........................................
###...........................................
###...........................................
#######################....###################
#######################....###################
#######################..==###################
