#####....#################
#####....#################
#####==..#################
###.......................
###.......................
###.......................
###.......................
###....###################
###....###################
###..==###################
