###....###################
###....###################
###==..###################
###.......................
###.......................
###.......................
###.......................
###############....#######
###############....#######
###############..==#######
