###....############################
###....############################
###==..############################
###................................
###................................
###................................
###................................
############....###################
############....###################
############..==###################
