###....###################
###....###################
###==..###################
###.......................
###.......................
###.......................
###.......................
##############....########
##############....########
##############..==########
