########################
#......................#
#......................#
#......................#
#......................#
#......................#
#......................#
#.......................
#.......................
#.......................
########################
########################
########################
