########################
#......................#
#......................#
#......................#
#......................#
#......................#
.......................#
.......................#
.......................#
.......................#
########################
########################
########################
