#################
#...............#
#...............#
#...............#
#...............#
#...............#
#...............#
#...............#
#................
#................
#................
#................
#################
#################
#################