#################
#...............#
#...............#
#...............#
#...............#
#...............#
#...............#
#...............#
................#
................#
................#
................#
#################
#################
#################