##############################
#............................#
#............................#
#............................#
#............................#
#............................#
#............................#
#............................#
#............................#
#............................#
.............................#
.............................#
.............................#
.............................#
##############################
##############################
##############################