#################
#...............#
#...............#
#...............#
#...............#
#...............#
#...............#
#...............#
.................
.................
.................
.................
#################
#################
#################
