##########
##########
##########
###.......
###.......
###.......
###.......
###....###
###....###
###..==###
