###....###
###....###
###....###
.....==###
.......###
.......###
.......###
##########
##########
##########
