##########
##########
##########
..........
..........
..........
..........
###....###
###....###
###..==###
