###################################
#.................................#
#.................................#
#.................................#
#===...........................===#
#.................................#
#.................................#
#.............=======.............#
#.................................#
#===...........................===#
..................................#
..................................#
..................................#
..................................#
###################################
###################################
###################################
