###################################
#.................................#
#.................................#
#.................................#
#===...........................===#
#.................................#
#.................................#
#.............=======.............#
#.................................#
#===...........................===#
#..................................
#..................................
#..................................
#..................................
###################################
###################################
###################################
