########################
#......................#
#......................#
#......................#
#......................#
#......................#
#......................#
#......................#
#......................#
#......................#
#......................#
#......................#
........................
........................
........................
........................
########################
########################
########################
