##############################
#............................#
#............................#
#............................#
#............................#
#............................#
#............................#
#............................#
#............................#
#............................#
#.............................
#.............................
#.............................
#.............................
##############################
##############################
##############################
