###################################
#.................................#
#.................................#
#.................................#
#===...........................===#
#.................................#
#.................................#
#.............=======.............#
#.................................#
#===...........................===#
...................................
...................................
...................................
...................................
###################################
###################################
###################################