###....##################################
###....##################################
###==..##################################
###......................................
###......................................
###......................................
###......................................
##################....###################
##################....###################
##################..==###################
