###....######################################################################
###....######################################################################
###==..######################################################################
###..........................................................................
###..........................................................................
###..........................................................................
###..........................................................................
######################################################....###################
######################################################....###################
######################################################..==###################
