###....############################################################
###....############################################################
###==..############################################################
###................................................................
###................................................................
###................................................................
###................................................................
############################################....###################
############################################....###################
############################################..==###################
