###....###################
###....###################
###==..###################
###.......................
###.......................
###.......................
###.......................
###################....###
###################....###
###################..==###
