###....#######################################################################
###....#######################################################################
###==..#######################################################################
###...........................................................................
###...........................................................................
###...........................................................................
###...........................................................................
#######################################################....###################
#######################################################....###################
#######################################################..==###################
