##########....############
##########....############
##########==..############
###.......................
###.......................
###.......................
###.......................
###....###################
###....###################
###..==###################
