###############....#######
###############....#######
###############==..#######
###.......................
###.......................
###.......................
###.......................
###....###################
###....###################
###..==###################
