###############################################....###################
###############################################....###################
###############################################==..###################
###...................................................................
###...................................................................
###...................................................................
###...................................................................
###....###############################################################
###....###############################################################
###..==###############################################################
