###....###################
###....###################
###==..###################
###.......................
###.......................
###.......................
###.......................
#####################....#
#####################....#
#####################..==#
