#################....######
#################....######
#################==..######
###........................
###........................
###........................
###........................
###....####################
###....####################
###..==####################
