###....##############################
###....##############################
###==..##############################
###..................................
###..................................
###..................................
###..................................
##############....###################
##############....###################
##############..==###################
