#############################....###################
#############################....###################
#############################==..###################
###.................................................
###.................................................
###.................................................
###.................................................
###....#############################################
###....#############################################
###..==#############################################
