###....############################################
###....############################################
###==..############################################
###................................................
###................................................
###................................................
###................................................
############################....###################
############################....###################
############################..==###################
