###....###################################################################
###....###################################################################
###==..###################################################################
###.......................................................................
###.......................................................................
###.......................................................................
###.......................................................................
###################################################....###################
###################################################....###################
###################################################..==###################
