###....##############################################################
###....##############################################################
###==..##############################################################
###..................................................................
###..................................................................
###..................................................................
###..................................................................
##############################################....###################
##############################################....###################
##############################################..==###################
