####....##################
####....##################
####==..##################
###.......................
###.......................
###.......................
###.......................
###....###################
###....###################
###..==###################
