###########....###########
###########....###########
###########==..###########
###.......................
###.......................
###.......................
###.......................
###....###################
###....###################
###..==###################
