###....###################
###....###################
###==..###################
###.......................
###.......................
###.......................
###.......................
##########....############
##########....############
##########..==############
