######################################....###################
######################################....###################
######################################==..###################
###..........................................................
###..........................................................
###..........................................................
###..........................................................
###....######################################################
###....######################################################
###..==######################################################
