###....########################
###....########################
###==..########################
###............................
###............................
###............................
###............................
########....###################
########....###################
########..==###################
