#################################################....###################
#################################################....###################
#################################################==..###################
###.....................................................................
###.....................................................................
###.....................................................................
###.....................................................................
###....#################################################################
###....#################################################################
###..==#################################################################
