###....######################################
###....######################################
###==..######################################
###..........................................
###..........................................
###..........................................
###..........................................
######################....###################
######################....###################
######################..==###################
