###....###################
###....###################
###==..###################
###.......................
###.......................
###.......................
###.......................
########....##############
########....##############
########..==##############
