###....###################
###....###################
###==..###################
###.......................
###.......................
###.......................
###.......................
######....################
######....################
######..==################
