###....##############
###....##############
###==..##############
###..................
###..................
###..................
###..................
####....#############
####....#############
####..==#############
