###....###############################
###....###############################
###==..###############################
###...................................
###...................................
###...................................
###...................................
###############....###################
###############....###################
###############..==###################
