###....###################################
###....###################################
###==..###################################
###.......................................
###.......................................
###.......................................
###.......................................
###################....###################
###################....###################
###################..==###################
