###....###########################
###....###########################
###==..###########################
###...............................
###...............................
###...............................
###...............................
###########....###################
###########....###################
###########..==###################
