####################....######
####################....######
####################==..######
###...........................
###...........................
###...........................
###...........................
###....#######################
###....#######################
###..==#######################
