######################################################....###################
######################################################....###################
######################################################==..###################
###..........................................................................
###..........................................................................
###..........................................................................
###..........................................................................
###....######################################################################
###....######################################################################
###..==######################################################################
