################################....###################
################################....###################
################################==..###################
###....................................................
###....................................................
###....................................................
###....................................................
###....################################################
###....################################################
###..==################################################
