####################################################....###################
####################################################....###################
####################################################==..###################
###........................................................................
###........................................................................
###........................................................................
###........................................................................
###....####################################################################
###....####################################################################
###..==####################################################################
