############################....###################
############################....###################
############################==..###################
###................................................
###................................................
###................................................
###................................................
###....############################################
###....############################################
###..==############################################
