########################################....###################
########################################....###################
########################################==..###################
###............................................................
###............................................................
###............................................................
###............................................................
###....########################################################
###....########################################################
###..==########################################################
