###########################################....###################
###########################################....###################
###########################################==..###################
###...............................................................
###...............................................................
###...............................................................
###...............................................................
###....###########################################################
###....###########################################################
###..==###########################################################
