###....##############
###....##############
###==..##############
###..................
###..................
###..................
###..................
#####....############
#####....############
#####..==############
