#########################....###################
#########################....###################
#########################==..###################
###.............................................
###.............................................
###.............................................
###.............................................
###....#########################################
###....#########################################
###..==#########################################
