##################....######
##################....######
##################==..######
###.........................
###.........................
###.........................
###.........................
###....#####################
###....#####################
###..==#####################
