###....###################
###....###################
###==..###################
###.......................
###.......................
###.......................
###.......................
############....##########
############....##########
############..==##########
