###....####################################################################
###....####################################################################
###==..####################################################################
###........................................................................
###........................................................................
###........................................................................
###........................................................................
####################################################....###################
####################################################....###################
####################################################..==###################
