###....###############################################
###....###############################################
###==..###############################################
###...................................................
###...................................................
###...................................................
###...................................................
###############################....###################
###############################....###################
###############################..==###################
