###....##################################################################
###....##################################################################
###==..##################################################################
###......................................................................
###......................................................................
###......................................................................
###......................................................................
##################################################....###################
##################################################....###################
##################################################..==###################
