###....######################################################
###....######################################################
###==..######################################################
###..........................................................
###..........................................................
###..........................................................
###..........................................................
######################################....###################
######################################....###################
######################################..==###################
