###....###################################################
###....###################################################
###==..###################################################
###.......................................................
###.......................................................
###.......................................................
###.......................................................
###################################....###################
###################################....###################
###################################..==###################
