#############....#########
#############....#########
#############==..#########
###.......................
###.......................
###.......................
###.......................
###....###################
###....###################
###..==###################
