###....#####################################
###....#####################################
###==..#####################################
###.........................................
###.........................................
###.........................................
###.........................................
#####################....###################
#####################....###################
#####################..==###################
