###....########################################################
###....########################################################
###==..########################################################
###............................................................
###............................................................
###............................................................
###............................................................
########################################....###################
########################################....###################
########################################..==###################
