###....###################
###....###################
###==..###################
###.......................
###.......................
###.......................
###.......................
#########....#############
#########....#############
#########..==#############
