##########################################....###################
##########################################....###################
##########################################==..###################
###..............................................................
###..............................................................
###..............................................................
###..............................................................
###....##########################################################
###....##########################################################
###..==##########################################################
