#############################################....###################
#############################################....###################
#############################################==..###################
###.................................................................
###.................................................................
###.................................................................
###.................................................................
###....#############################################################
###....#############################################################
###..==#############################################################
