##################################....###################
##################################....###################
##################################==..###################
###......................................................
###......................................................
###......................................................
###......................................................
###....##################################################
###....##################################################
###..==##################################################
