#######################....###################
#######################....###################
#######################==..###################
###...........................................
###...........................................
###...........................................
###...........................................
###....#######################################
###....#######################################
###..==#######################################
