###....####################################
###....####################################
###==..####################################
###........................................
###........................................
###........................................
###........................................
####################....###################
####################....###################
####################..==###################
