################################################....###################
################################################....###################
################################################==..###################
###....................................................................
###....................................................................
###....................................................................
###....................................................................
###....################################################################
###....################################################################
###..==################################################################
