###....#############################################################
###....#############################################################
###==..#############################################################
###.................................................................
###.................................................................
###.................................................................
###.................................................................
#############################################....###################
#############################################....###################
#############################################..==###################
