###############################....###################
###############################....###################
###############################==..###################
###...................................................
###...................................................
###...................................................
###...................................................
###....###############################################
###....###############################################
###..==###############################################
