#####################################################....###################
#####################################################....###################
#####################################################==..###################
###.........................................................................
###.........................................................................
###.........................................................................
###.........................................................................
###....#####################################################################
###....#####################################################################
###..==#####################################################################
