##############################################....###################
##############################################....###################
##############################################==..###################
###..................................................................
###..................................................................
###..................................................................
###..................................................................
###....##############################################################
###....##############################################################
###..==##############################################################
