##############....########
##############....########
##############==..########
###.......................
###.......................
###.......................
###.......................
###....###################
###....###################
###..==###################
