##########################....###################
##########################....###################
##########################==..###################
###..............................................
###..............................................
###..............................................
###..............................................
###....##########################################
###....##########################################
###..==##########################################
