##############################....###################
##############################....###################
##############################==..###################
###..................................................
###..................................................
###..................................................
###..................................................
###....##############################################
###....##############################################
###..==##############################################
