###....###
###....###
###....###
###==.....
###.......
###.......
###.......
##########
##########
##########
