##########
##########
##########
.......###
.......###
.......###
.......###
###....###
###....###
###..==###
