###....###
###....###
###....###
###==.....
###.......
###.......
###.......
###....###
###....###
###..==###
