###....###
###....###
###....###
.......###
.....==###
.......###
.......###
###....###
###....###
###..==###
