###....###
###....###
###==..###
..........
..........
..........
..........
##########
##########
##########
