###....###
###....###
###==..###
..........
..........
..........
..........
###....###
###....###
###..==###