###....###
###....###
###....###
###....###
###==..###
###....###
###....###
###....###
###....###
###..==###
