###....###
###....###
###....###
####....###
####==..###
####....###
####....###
####....###
###....###
###..==###
